Acrofobia - frica de înălțimi
Agorafobia - frica de spațiile deschise sau aglomerate
Arachnofobia - frica de păianjeni
Astrafobia - frica de fulgere și tunete
Claustrofobia - frica de spațiile înguste sau închise
Coulrofobia - frica de clovni
Dentofobia - frica de dentist sau procedurile stomatologice
Entomofobia - frica de insecte
Hematofobia - frica de sânge
Hidrofobia - frica de apă
Meningofobia - frica de boala meningitei
Necrofobia - frica de moarte sau cadavre
Oftalmofobia - frica de ochi sau proceduri oftalmologice
Ornithofobia - frica de păsări
Frica de înghițit (Phagophobia)
Germofobia - frica de germeni și microbi
Xenofobia - frica de străini sau lucruri necunoscute
Zoofobia - frica de animale în general sau de anumite animale
Androfobia - frica de bărbați
Ginecofobia - frica de femei sau de sexul feminin
Homofobia - frica de homosexualitate
Heterofobia - frica de persoanele de sex opus
Islamofobia - frica de religia islamică
Judeofobia - frica de evrei
Cristofobia - frica de creștini
Acusticofobia - frica de sunete puternice
Autodistructivitate
Basofobia - frica de căderea obiectelor
Cardiophobia - frica de boli de inima sau bataile inimii
Demofobia - frica de mulțimi sau a societății în general
Frigofobia - frica de frig sau de obiectele reci
Geumafobia - frica de gusturi sau a alimentelor în general
Hepatofobia - frica de boli ale ficatului
Iatrophobia - frica de medici și de tratamente medicale
Kakorrhaphiophobia - frica de a scrie sau de a vorbi în public
Ligyrophobia - frica de zgomote puternice sau neașteptate
Metalofobia - frica de metale sau de obiecte din metal
Nictofobia - frica de întuneric sau de noapte
Ochlophobia - frica de mulțimi sau de locurile aglomerate
Pogonofobia - frica de bărbi sau de persoane barbate
Querulantenwahn - frica de judecăți injuste sau de a fi persecutat
Rhytiphobia - frica de riduri sau îmbătrânire